FWI_FL/CurveVel_A/data/data1.npy	FWI_FL/CurveVel_A/frequency/frequency1.npy	FWI_FL/CurveVel_A/model/model1.npy
FWI_FL/CurveVel_A/data/data2.npy	FWI_FL/CurveVel_A/frequency/frequency2.npy	FWI_FL/CurveVel_A/model/model2.npy
FWI_FL/CurveVel_A/data/data3.npy	FWI_FL/CurveVel_A/frequency/frequency3.npy	FWI_FL/CurveVel_A/model/model3.npy
FWI_FL/CurveVel_A/data/data4.npy	FWI_FL/CurveVel_A/frequency/frequency4.npy	FWI_FL/CurveVel_A/model/model4.npy
FWI_FL/CurveVel_A/data/data5.npy	FWI_FL/CurveVel_A/frequency/frequency5.npy	FWI_FL/CurveVel_A/model/model5.npy
FWI_FL/CurveVel_A/data/data6.npy	FWI_FL/CurveVel_A/frequency/frequency6.npy	FWI_FL/CurveVel_A/model/model6.npy
FWI_FL/CurveVel_A/data/data7.npy	FWI_FL/CurveVel_A/frequency/frequency7.npy	FWI_FL/CurveVel_A/model/model7.npy
FWI_FL/CurveVel_A/data/data8.npy	FWI_FL/CurveVel_A/frequency/frequency8.npy	FWI_FL/CurveVel_A/model/model8.npy
FWI_FL/CurveVel_A/data/data9.npy	FWI_FL/CurveVel_A/frequency/frequency9.npy	FWI_FL/CurveVel_A/model/model9.npy
FWI_FL/CurveVel_A/data/data10.npy	FWI_FL/CurveVel_A/frequency/frequency10.npy	FWI_FL/CurveVel_A/model/model10.npy
FWI_FL/CurveVel_A/data/data11.npy	FWI_FL/CurveVel_A/frequency/frequency11.npy	FWI_FL/CurveVel_A/model/model11.npy
FWI_FL/CurveVel_A/data/data12.npy	FWI_FL/CurveVel_A/frequency/frequency12.npy	FWI_FL/CurveVel_A/model/model12.npy
FWI_FL/CurveVel_A/data/data13.npy	FWI_FL/CurveVel_A/frequency/frequency13.npy	FWI_FL/CurveVel_A/model/model13.npy
FWI_FL/CurveVel_A/data/data14.npy	FWI_FL/CurveVel_A/frequency/frequency14.npy	FWI_FL/CurveVel_A/model/model14.npy
FWI_FL/CurveVel_A/data/data15.npy	FWI_FL/CurveVel_A/frequency/frequency15.npy	FWI_FL/CurveVel_A/model/model15.npy
FWI_FL/CurveVel_A/data/data16.npy	FWI_FL/CurveVel_A/frequency/frequency16.npy	FWI_FL/CurveVel_A/model/model16.npy
FWI_FL/CurveVel_A/data/data17.npy	FWI_FL/CurveVel_A/frequency/frequency17.npy	FWI_FL/CurveVel_A/model/model17.npy
FWI_FL/CurveVel_A/data/data18.npy	FWI_FL/CurveVel_A/frequency/frequency18.npy	FWI_FL/CurveVel_A/model/model18.npy
FWI_FL/CurveVel_A/data/data19.npy	FWI_FL/CurveVel_A/frequency/frequency19.npy	FWI_FL/CurveVel_A/model/model19.npy
FWI_FL/CurveVel_A/data/data20.npy	FWI_FL/CurveVel_A/frequency/frequency20.npy	FWI_FL/CurveVel_A/model/model20.npy
FWI_FL/CurveVel_A/data/data21.npy	FWI_FL/CurveVel_A/frequency/frequency21.npy	FWI_FL/CurveVel_A/model/model21.npy
FWI_FL/CurveVel_A/data/data22.npy	FWI_FL/CurveVel_A/frequency/frequency22.npy	FWI_FL/CurveVel_A/model/model22.npy
FWI_FL/CurveVel_A/data/data23.npy	FWI_FL/CurveVel_A/frequency/frequency23.npy	FWI_FL/CurveVel_A/model/model23.npy
FWI_FL/CurveVel_A/data/data24.npy	FWI_FL/CurveVel_A/frequency/frequency24.npy	FWI_FL/CurveVel_A/model/model24.npy
FWI_FL/CurveVel_A/data/data25.npy	FWI_FL/CurveVel_A/frequency/frequency25.npy	FWI_FL/CurveVel_A/model/model25.npy
FWI_FL/CurveVel_A/data/data26.npy	FWI_FL/CurveVel_A/frequency/frequency26.npy	FWI_FL/CurveVel_A/model/model26.npy
FWI_FL/CurveVel_A/data/data27.npy	FWI_FL/CurveVel_A/frequency/frequency27.npy	FWI_FL/CurveVel_A/model/model27.npy
FWI_FL/CurveVel_A/data/data28.npy	FWI_FL/CurveVel_A/frequency/frequency28.npy	FWI_FL/CurveVel_A/model/model28.npy
FWI_FL/CurveVel_A/data/data29.npy	FWI_FL/CurveVel_A/frequency/frequency29.npy	FWI_FL/CurveVel_A/model/model29.npy
FWI_FL/CurveVel_A/data/data30.npy	FWI_FL/CurveVel_A/frequency/frequency30.npy	FWI_FL/CurveVel_A/model/model30.npy
FWI_FL/CurveVel_A/data/data31.npy	FWI_FL/CurveVel_A/frequency/frequency31.npy	FWI_FL/CurveVel_A/model/model31.npy
FWI_FL/CurveVel_A/data/data32.npy	FWI_FL/CurveVel_A/frequency/frequency32.npy	FWI_FL/CurveVel_A/model/model32.npy
FWI_FL/CurveVel_A/data/data33.npy	FWI_FL/CurveVel_A/frequency/frequency33.npy	FWI_FL/CurveVel_A/model/model33.npy
FWI_FL/CurveVel_A/data/data34.npy	FWI_FL/CurveVel_A/frequency/frequency34.npy	FWI_FL/CurveVel_A/model/model34.npy
FWI_FL/CurveVel_A/data/data35.npy	FWI_FL/CurveVel_A/frequency/frequency35.npy	FWI_FL/CurveVel_A/model/model35.npy
FWI_FL/CurveVel_A/data/data36.npy	FWI_FL/CurveVel_A/frequency/frequency36.npy	FWI_FL/CurveVel_A/model/model36.npy
FWI_FL/CurveVel_A/data/data37.npy	FWI_FL/CurveVel_A/frequency/frequency37.npy	FWI_FL/CurveVel_A/model/model37.npy
FWI_FL/CurveVel_A/data/data38.npy	FWI_FL/CurveVel_A/frequency/frequency38.npy	FWI_FL/CurveVel_A/model/model38.npy
FWI_FL/CurveVel_A/data/data39.npy	FWI_FL/CurveVel_A/frequency/frequency39.npy	FWI_FL/CurveVel_A/model/model39.npy
FWI_FL/CurveVel_A/data/data40.npy	FWI_FL/CurveVel_A/frequency/frequency40.npy	FWI_FL/CurveVel_A/model/model40.npy
FWI_FL/CurveVel_A/data/data41.npy	FWI_FL/CurveVel_A/frequency/frequency41.npy	FWI_FL/CurveVel_A/model/model41.npy
FWI_FL/CurveVel_A/data/data42.npy	FWI_FL/CurveVel_A/frequency/frequency42.npy	FWI_FL/CurveVel_A/model/model42.npy
FWI_FL/CurveVel_A/data/data43.npy	FWI_FL/CurveVel_A/frequency/frequency43.npy	FWI_FL/CurveVel_A/model/model43.npy
FWI_FL/CurveVel_A/data/data44.npy	FWI_FL/CurveVel_A/frequency/frequency44.npy	FWI_FL/CurveVel_A/model/model44.npy
FWI_FL/CurveVel_A/data/data45.npy	FWI_FL/CurveVel_A/frequency/frequency45.npy	FWI_FL/CurveVel_A/model/model45.npy
FWI_FL/CurveVel_A/data/data46.npy	FWI_FL/CurveVel_A/frequency/frequency46.npy	FWI_FL/CurveVel_A/model/model46.npy
FWI_FL/CurveVel_A/data/data47.npy	FWI_FL/CurveVel_A/frequency/frequency47.npy	FWI_FL/CurveVel_A/model/model47.npy
FWI_FL/CurveVel_A/data/data48.npy	FWI_FL/CurveVel_A/frequency/frequency48.npy	FWI_FL/CurveVel_A/model/model48.npy
