FWI_FL/CurveFault_A/data/data1.npy	FWI_FL/CurveFault_A/frequency/frequency1.npy	FWI_FL/CurveFault_A/source/source1.npy	FWI_FL/CurveFault_A/model/model1.npy
FWI_FL/CurveFault_A/data/data2.npy	FWI_FL/CurveFault_A/frequency/frequency2.npy	FWI_FL/CurveFault_A/source/source2.npy	FWI_FL/CurveFault_A/model/model2.npy
FWI_FL/CurveFault_A/data/data3.npy	FWI_FL/CurveFault_A/frequency/frequency3.npy	FWI_FL/CurveFault_A/source/source3.npy	FWI_FL/CurveFault_A/model/model3.npy
FWI_FL/CurveFault_A/data/data4.npy	FWI_FL/CurveFault_A/frequency/frequency4.npy	FWI_FL/CurveFault_A/source/source4.npy	FWI_FL/CurveFault_A/model/model4.npy
FWI_FL/CurveFault_A/data/data5.npy	FWI_FL/CurveFault_A/frequency/frequency5.npy	FWI_FL/CurveFault_A/source/source5.npy	FWI_FL/CurveFault_A/model/model5.npy
FWI_FL/CurveFault_A/data/data6.npy	FWI_FL/CurveFault_A/frequency/frequency6.npy	FWI_FL/CurveFault_A/source/source6.npy	FWI_FL/CurveFault_A/model/model6.npy
FWI_FL/CurveFault_A/data/data7.npy	FWI_FL/CurveFault_A/frequency/frequency7.npy	FWI_FL/CurveFault_A/source/source7.npy	FWI_FL/CurveFault_A/model/model7.npy
FWI_FL/CurveFault_A/data/data8.npy	FWI_FL/CurveFault_A/frequency/frequency8.npy	FWI_FL/CurveFault_A/source/source8.npy	FWI_FL/CurveFault_A/model/model8.npy
FWI_FL/CurveFault_A/data/data9.npy	FWI_FL/CurveFault_A/frequency/frequency9.npy	FWI_FL/CurveFault_A/source/source9.npy	FWI_FL/CurveFault_A/model/model9.npy
FWI_FL/CurveFault_A/data/data10.npy	FWI_FL/CurveFault_A/frequency/frequency10.npy	FWI_FL/CurveFault_A/source/source10.npy	FWI_FL/CurveFault_A/model/model10.npy
FWI_FL/CurveFault_A/data/data11.npy	FWI_FL/CurveFault_A/frequency/frequency11.npy	FWI_FL/CurveFault_A/source/source11.npy	FWI_FL/CurveFault_A/model/model11.npy
FWI_FL/CurveFault_A/data/data12.npy	FWI_FL/CurveFault_A/frequency/frequency12.npy	FWI_FL/CurveFault_A/source/source12.npy	FWI_FL/CurveFault_A/model/model12.npy
FWI_FL/CurveFault_A/data/data13.npy	FWI_FL/CurveFault_A/frequency/frequency13.npy	FWI_FL/CurveFault_A/source/source13.npy	FWI_FL/CurveFault_A/model/model13.npy
FWI_FL/CurveFault_A/data/data14.npy	FWI_FL/CurveFault_A/frequency/frequency14.npy	FWI_FL/CurveFault_A/source/source14.npy	FWI_FL/CurveFault_A/model/model14.npy
FWI_FL/CurveFault_A/data/data15.npy	FWI_FL/CurveFault_A/frequency/frequency15.npy	FWI_FL/CurveFault_A/source/source15.npy	FWI_FL/CurveFault_A/model/model15.npy
FWI_FL/CurveFault_A/data/data16.npy	FWI_FL/CurveFault_A/frequency/frequency16.npy	FWI_FL/CurveFault_A/source/source16.npy	FWI_FL/CurveFault_A/model/model16.npy
FWI_FL/CurveFault_A/data/data17.npy	FWI_FL/CurveFault_A/frequency/frequency17.npy	FWI_FL/CurveFault_A/source/source17.npy	FWI_FL/CurveFault_A/model/model17.npy
FWI_FL/CurveFault_A/data/data18.npy	FWI_FL/CurveFault_A/frequency/frequency18.npy	FWI_FL/CurveFault_A/source/source18.npy	FWI_FL/CurveFault_A/model/model18.npy
FWI_FL/CurveFault_A/data/data19.npy	FWI_FL/CurveFault_A/frequency/frequency19.npy	FWI_FL/CurveFault_A/source/source19.npy	FWI_FL/CurveFault_A/model/model19.npy
FWI_FL/CurveFault_A/data/data20.npy	FWI_FL/CurveFault_A/frequency/frequency20.npy	FWI_FL/CurveFault_A/source/source20.npy	FWI_FL/CurveFault_A/model/model20.npy
FWI_FL/CurveFault_A/data/data21.npy	FWI_FL/CurveFault_A/frequency/frequency21.npy	FWI_FL/CurveFault_A/source/source21.npy	FWI_FL/CurveFault_A/model/model21.npy
FWI_FL/CurveFault_A/data/data22.npy	FWI_FL/CurveFault_A/frequency/frequency22.npy	FWI_FL/CurveFault_A/source/source22.npy	FWI_FL/CurveFault_A/model/model22.npy
FWI_FL/CurveFault_A/data/data23.npy	FWI_FL/CurveFault_A/frequency/frequency23.npy	FWI_FL/CurveFault_A/source/source23.npy	FWI_FL/CurveFault_A/model/model23.npy
FWI_FL/CurveFault_A/data/data24.npy	FWI_FL/CurveFault_A/frequency/frequency24.npy	FWI_FL/CurveFault_A/source/source24.npy	FWI_FL/CurveFault_A/model/model24.npy
FWI_FL/CurveFault_A/data/data25.npy	FWI_FL/CurveFault_A/frequency/frequency25.npy	FWI_FL/CurveFault_A/source/source25.npy	FWI_FL/CurveFault_A/model/model25.npy
FWI_FL/CurveFault_A/data/data26.npy	FWI_FL/CurveFault_A/frequency/frequency26.npy	FWI_FL/CurveFault_A/source/source26.npy	FWI_FL/CurveFault_A/model/model26.npy
FWI_FL/CurveFault_A/data/data27.npy	FWI_FL/CurveFault_A/frequency/frequency27.npy	FWI_FL/CurveFault_A/source/source27.npy	FWI_FL/CurveFault_A/model/model27.npy
FWI_FL/CurveFault_A/data/data28.npy	FWI_FL/CurveFault_A/frequency/frequency28.npy	FWI_FL/CurveFault_A/source/source28.npy	FWI_FL/CurveFault_A/model/model28.npy
FWI_FL/CurveFault_A/data/data29.npy	FWI_FL/CurveFault_A/frequency/frequency29.npy	FWI_FL/CurveFault_A/source/source29.npy	FWI_FL/CurveFault_A/model/model29.npy
FWI_FL/CurveFault_A/data/data30.npy	FWI_FL/CurveFault_A/frequency/frequency30.npy	FWI_FL/CurveFault_A/source/source30.npy	FWI_FL/CurveFault_A/model/model30.npy
FWI_FL/CurveFault_A/data/data31.npy	FWI_FL/CurveFault_A/frequency/frequency31.npy	FWI_FL/CurveFault_A/source/source31.npy	FWI_FL/CurveFault_A/model/model31.npy
FWI_FL/CurveFault_A/data/data32.npy	FWI_FL/CurveFault_A/frequency/frequency32.npy	FWI_FL/CurveFault_A/source/source32.npy	FWI_FL/CurveFault_A/model/model32.npy
FWI_FL/CurveFault_A/data/data33.npy	FWI_FL/CurveFault_A/frequency/frequency33.npy	FWI_FL/CurveFault_A/source/source33.npy	FWI_FL/CurveFault_A/model/model33.npy
FWI_FL/CurveFault_A/data/data34.npy	FWI_FL/CurveFault_A/frequency/frequency34.npy	FWI_FL/CurveFault_A/source/source34.npy	FWI_FL/CurveFault_A/model/model34.npy
FWI_FL/CurveFault_A/data/data35.npy	FWI_FL/CurveFault_A/frequency/frequency35.npy	FWI_FL/CurveFault_A/source/source35.npy	FWI_FL/CurveFault_A/model/model35.npy
FWI_FL/CurveFault_A/data/data36.npy	FWI_FL/CurveFault_A/frequency/frequency36.npy	FWI_FL/CurveFault_A/source/source36.npy	FWI_FL/CurveFault_A/model/model36.npy
FWI_FL/CurveFault_A/data/data37.npy	FWI_FL/CurveFault_A/frequency/frequency37.npy	FWI_FL/CurveFault_A/source/source37.npy	FWI_FL/CurveFault_A/model/model37.npy
FWI_FL/CurveFault_A/data/data38.npy	FWI_FL/CurveFault_A/frequency/frequency38.npy	FWI_FL/CurveFault_A/source/source38.npy	FWI_FL/CurveFault_A/model/model38.npy
FWI_FL/CurveFault_A/data/data39.npy	FWI_FL/CurveFault_A/frequency/frequency39.npy	FWI_FL/CurveFault_A/source/source39.npy	FWI_FL/CurveFault_A/model/model39.npy
FWI_FL/CurveFault_A/data/data40.npy	FWI_FL/CurveFault_A/frequency/frequency40.npy	FWI_FL/CurveFault_A/source/source40.npy	FWI_FL/CurveFault_A/model/model40.npy
FWI_FL/CurveFault_A/data/data41.npy	FWI_FL/CurveFault_A/frequency/frequency41.npy	FWI_FL/CurveFault_A/source/source41.npy	FWI_FL/CurveFault_A/model/model41.npy
FWI_FL/CurveFault_A/data/data42.npy	FWI_FL/CurveFault_A/frequency/frequency42.npy	FWI_FL/CurveFault_A/source/source42.npy	FWI_FL/CurveFault_A/model/model42.npy
FWI_FL/CurveFault_A/data/data43.npy	FWI_FL/CurveFault_A/frequency/frequency43.npy	FWI_FL/CurveFault_A/source/source43.npy	FWI_FL/CurveFault_A/model/model43.npy
FWI_FL/CurveFault_A/data/data44.npy	FWI_FL/CurveFault_A/frequency/frequency44.npy	FWI_FL/CurveFault_A/source/source44.npy	FWI_FL/CurveFault_A/model/model44.npy
FWI_FL/CurveFault_A/data/data45.npy	FWI_FL/CurveFault_A/frequency/frequency45.npy	FWI_FL/CurveFault_A/source/source45.npy	FWI_FL/CurveFault_A/model/model45.npy
FWI_FL/CurveFault_A/data/data46.npy	FWI_FL/CurveFault_A/frequency/frequency46.npy	FWI_FL/CurveFault_A/source/source46.npy	FWI_FL/CurveFault_A/model/model46.npy
FWI_FL/CurveFault_A/data/data47.npy	FWI_FL/CurveFault_A/frequency/frequency47.npy	FWI_FL/CurveFault_A/source/source47.npy	FWI_FL/CurveFault_A/model/model47.npy
FWI_FL/CurveFault_A/data/data48.npy	FWI_FL/CurveFault_A/frequency/frequency48.npy	FWI_FL/CurveFault_A/source/source48.npy	FWI_FL/CurveFault_A/model/model48.npy
FWI_FL/CurveFault_A/data/data49.npy	FWI_FL/CurveFault_A/frequency/frequency49.npy	FWI_FL/CurveFault_A/source/source49.npy	FWI_FL/CurveFault_A/model/model49.npy
FWI_FL/CurveFault_A/data/data50.npy	FWI_FL/CurveFault_A/frequency/frequency50.npy	FWI_FL/CurveFault_A/source/source50.npy	FWI_FL/CurveFault_A/model/model50.npy
FWI_FL/CurveFault_A/data/data51.npy	FWI_FL/CurveFault_A/frequency/frequency51.npy	FWI_FL/CurveFault_A/source/source51.npy	FWI_FL/CurveFault_A/model/model51.npy
FWI_FL/CurveFault_A/data/data52.npy	FWI_FL/CurveFault_A/frequency/frequency52.npy	FWI_FL/CurveFault_A/source/source52.npy	FWI_FL/CurveFault_A/model/model52.npy
FWI_FL/CurveFault_A/data/data53.npy	FWI_FL/CurveFault_A/frequency/frequency53.npy	FWI_FL/CurveFault_A/source/source53.npy	FWI_FL/CurveFault_A/model/model53.npy
FWI_FL/CurveFault_A/data/data54.npy	FWI_FL/CurveFault_A/frequency/frequency54.npy	FWI_FL/CurveFault_A/source/source54.npy	FWI_FL/CurveFault_A/model/model54.npy
FWI_FL/CurveFault_A/data/data55.npy	FWI_FL/CurveFault_A/frequency/frequency55.npy	FWI_FL/CurveFault_A/source/source55.npy	FWI_FL/CurveFault_A/model/model55.npy
FWI_FL/CurveFault_A/data/data56.npy	FWI_FL/CurveFault_A/frequency/frequency56.npy	FWI_FL/CurveFault_A/source/source56.npy	FWI_FL/CurveFault_A/model/model56.npy
FWI_FL/CurveFault_A/data/data57.npy	FWI_FL/CurveFault_A/frequency/frequency57.npy	FWI_FL/CurveFault_A/source/source57.npy	FWI_FL/CurveFault_A/model/model57.npy
FWI_FL/CurveFault_A/data/data58.npy	FWI_FL/CurveFault_A/frequency/frequency58.npy	FWI_FL/CurveFault_A/source/source58.npy	FWI_FL/CurveFault_A/model/model58.npy
FWI_FL/CurveFault_A/data/data59.npy	FWI_FL/CurveFault_A/frequency/frequency59.npy	FWI_FL/CurveFault_A/source/source59.npy	FWI_FL/CurveFault_A/model/model59.npy
FWI_FL/CurveFault_A/data/data60.npy	FWI_FL/CurveFault_A/frequency/frequency60.npy	FWI_FL/CurveFault_A/source/source60.npy	FWI_FL/CurveFault_A/model/model60.npy
FWI_FL/CurveFault_A/data/data61.npy	FWI_FL/CurveFault_A/frequency/frequency61.npy	FWI_FL/CurveFault_A/source/source61.npy	FWI_FL/CurveFault_A/model/model61.npy
FWI_FL/CurveFault_A/data/data62.npy	FWI_FL/CurveFault_A/frequency/frequency62.npy	FWI_FL/CurveFault_A/source/source62.npy	FWI_FL/CurveFault_A/model/model62.npy
FWI_FL/CurveFault_A/data/data63.npy	FWI_FL/CurveFault_A/frequency/frequency63.npy	FWI_FL/CurveFault_A/source/source63.npy	FWI_FL/CurveFault_A/model/model63.npy
FWI_FL/CurveFault_A/data/data64.npy	FWI_FL/CurveFault_A/frequency/frequency64.npy	FWI_FL/CurveFault_A/source/source64.npy	FWI_FL/CurveFault_A/model/model64.npy
FWI_FL/CurveFault_A/data/data65.npy	FWI_FL/CurveFault_A/frequency/frequency65.npy	FWI_FL/CurveFault_A/source/source65.npy	FWI_FL/CurveFault_A/model/model65.npy
FWI_FL/CurveFault_A/data/data66.npy	FWI_FL/CurveFault_A/frequency/frequency66.npy	FWI_FL/CurveFault_A/source/source66.npy	FWI_FL/CurveFault_A/model/model66.npy
FWI_FL/CurveFault_A/data/data67.npy	FWI_FL/CurveFault_A/frequency/frequency67.npy	FWI_FL/CurveFault_A/source/source67.npy	FWI_FL/CurveFault_A/model/model67.npy
FWI_FL/CurveFault_A/data/data68.npy	FWI_FL/CurveFault_A/frequency/frequency68.npy	FWI_FL/CurveFault_A/source/source68.npy	FWI_FL/CurveFault_A/model/model68.npy
FWI_FL/CurveFault_A/data/data69.npy	FWI_FL/CurveFault_A/frequency/frequency69.npy	FWI_FL/CurveFault_A/source/source69.npy	FWI_FL/CurveFault_A/model/model69.npy
FWI_FL/CurveFault_A/data/data70.npy	FWI_FL/CurveFault_A/frequency/frequency70.npy	FWI_FL/CurveFault_A/source/source70.npy	FWI_FL/CurveFault_A/model/model70.npy
FWI_FL/CurveFault_A/data/data71.npy	FWI_FL/CurveFault_A/frequency/frequency71.npy	FWI_FL/CurveFault_A/source/source71.npy	FWI_FL/CurveFault_A/model/model71.npy
FWI_FL/CurveFault_A/data/data72.npy	FWI_FL/CurveFault_A/frequency/frequency72.npy	FWI_FL/CurveFault_A/source/source72.npy	FWI_FL/CurveFault_A/model/model72.npy
FWI_FL/CurveFault_A/data/data73.npy	FWI_FL/CurveFault_A/frequency/frequency73.npy	FWI_FL/CurveFault_A/source/source73.npy	FWI_FL/CurveFault_A/model/model73.npy
FWI_FL/CurveFault_A/data/data74.npy	FWI_FL/CurveFault_A/frequency/frequency74.npy	FWI_FL/CurveFault_A/source/source74.npy	FWI_FL/CurveFault_A/model/model74.npy
FWI_FL/CurveFault_A/data/data75.npy	FWI_FL/CurveFault_A/frequency/frequency75.npy	FWI_FL/CurveFault_A/source/source75.npy	FWI_FL/CurveFault_A/model/model75.npy
FWI_FL/CurveFault_A/data/data76.npy	FWI_FL/CurveFault_A/frequency/frequency76.npy	FWI_FL/CurveFault_A/source/source76.npy	FWI_FL/CurveFault_A/model/model76.npy
FWI_FL/CurveFault_A/data/data77.npy	FWI_FL/CurveFault_A/frequency/frequency77.npy	FWI_FL/CurveFault_A/source/source77.npy	FWI_FL/CurveFault_A/model/model77.npy
FWI_FL/CurveFault_A/data/data78.npy	FWI_FL/CurveFault_A/frequency/frequency78.npy	FWI_FL/CurveFault_A/source/source78.npy	FWI_FL/CurveFault_A/model/model78.npy
FWI_FL/CurveFault_A/data/data79.npy	FWI_FL/CurveFault_A/frequency/frequency79.npy	FWI_FL/CurveFault_A/source/source79.npy	FWI_FL/CurveFault_A/model/model79.npy
FWI_FL/CurveFault_A/data/data80.npy	FWI_FL/CurveFault_A/frequency/frequency80.npy	FWI_FL/CurveFault_A/source/source80.npy	FWI_FL/CurveFault_A/model/model80.npy
FWI_FL/CurveFault_A/data/data81.npy	FWI_FL/CurveFault_A/frequency/frequency81.npy	FWI_FL/CurveFault_A/source/source81.npy	FWI_FL/CurveFault_A/model/model81.npy
FWI_FL/CurveFault_A/data/data82.npy	FWI_FL/CurveFault_A/frequency/frequency82.npy	FWI_FL/CurveFault_A/source/source82.npy	FWI_FL/CurveFault_A/model/model82.npy
FWI_FL/CurveFault_A/data/data83.npy	FWI_FL/CurveFault_A/frequency/frequency83.npy	FWI_FL/CurveFault_A/source/source83.npy	FWI_FL/CurveFault_A/model/model83.npy
FWI_FL/CurveFault_A/data/data84.npy	FWI_FL/CurveFault_A/frequency/frequency84.npy	FWI_FL/CurveFault_A/source/source84.npy	FWI_FL/CurveFault_A/model/model84.npy
FWI_FL/CurveFault_A/data/data85.npy	FWI_FL/CurveFault_A/frequency/frequency85.npy	FWI_FL/CurveFault_A/source/source85.npy	FWI_FL/CurveFault_A/model/model85.npy
FWI_FL/CurveFault_A/data/data86.npy	FWI_FL/CurveFault_A/frequency/frequency86.npy	FWI_FL/CurveFault_A/source/source86.npy	FWI_FL/CurveFault_A/model/model86.npy
FWI_FL/CurveFault_A/data/data87.npy	FWI_FL/CurveFault_A/frequency/frequency87.npy	FWI_FL/CurveFault_A/source/source87.npy	FWI_FL/CurveFault_A/model/model87.npy
FWI_FL/CurveFault_A/data/data88.npy	FWI_FL/CurveFault_A/frequency/frequency88.npy	FWI_FL/CurveFault_A/source/source88.npy	FWI_FL/CurveFault_A/model/model88.npy
FWI_FL/CurveFault_A/data/data89.npy	FWI_FL/CurveFault_A/frequency/frequency89.npy	FWI_FL/CurveFault_A/source/source89.npy	FWI_FL/CurveFault_A/model/model89.npy
FWI_FL/CurveFault_A/data/data90.npy	FWI_FL/CurveFault_A/frequency/frequency90.npy	FWI_FL/CurveFault_A/source/source90.npy	FWI_FL/CurveFault_A/model/model90.npy
FWI_FL/CurveFault_A/data/data91.npy	FWI_FL/CurveFault_A/frequency/frequency91.npy	FWI_FL/CurveFault_A/source/source91.npy	FWI_FL/CurveFault_A/model/model91.npy
FWI_FL/CurveFault_A/data/data92.npy	FWI_FL/CurveFault_A/frequency/frequency92.npy	FWI_FL/CurveFault_A/source/source92.npy	FWI_FL/CurveFault_A/model/model92.npy
FWI_FL/CurveFault_A/data/data93.npy	FWI_FL/CurveFault_A/frequency/frequency93.npy	FWI_FL/CurveFault_A/source/source93.npy	FWI_FL/CurveFault_A/model/model93.npy
FWI_FL/CurveFault_A/data/data94.npy	FWI_FL/CurveFault_A/frequency/frequency94.npy	FWI_FL/CurveFault_A/source/source94.npy	FWI_FL/CurveFault_A/model/model94.npy
FWI_FL/CurveFault_A/data/data95.npy	FWI_FL/CurveFault_A/frequency/frequency95.npy	FWI_FL/CurveFault_A/source/source95.npy	FWI_FL/CurveFault_A/model/model95.npy
FWI_FL/CurveFault_A/data/data96.npy	FWI_FL/CurveFault_A/frequency/frequency96.npy	FWI_FL/CurveFault_A/source/source96.npy	FWI_FL/CurveFault_A/model/model96.npy
