FWI_F/FlatFault_B/data/data1.npy	FWI_F/FlatFault_B/frequency/frequency1.npy	FWI_F/FlatFault_B/model/model1.npy
FWI_F/FlatFault_B/data/data2.npy	FWI_F/FlatFault_B/frequency/frequency2.npy	FWI_F/FlatFault_B/model/model2.npy
FWI_F/FlatFault_B/data/data3.npy	FWI_F/FlatFault_B/frequency/frequency3.npy	FWI_F/FlatFault_B/model/model3.npy
FWI_F/FlatFault_B/data/data4.npy	FWI_F/FlatFault_B/frequency/frequency4.npy	FWI_F/FlatFault_B/model/model4.npy
FWI_F/FlatFault_B/data/data5.npy	FWI_F/FlatFault_B/frequency/frequency5.npy	FWI_F/FlatFault_B/model/model5.npy
FWI_F/FlatFault_B/data/data6.npy	FWI_F/FlatFault_B/frequency/frequency6.npy	FWI_F/FlatFault_B/model/model6.npy
FWI_F/FlatFault_B/data/data7.npy	FWI_F/FlatFault_B/frequency/frequency7.npy	FWI_F/FlatFault_B/model/model7.npy
FWI_F/FlatFault_B/data/data8.npy	FWI_F/FlatFault_B/frequency/frequency8.npy	FWI_F/FlatFault_B/model/model8.npy
FWI_F/FlatFault_B/data/data9.npy	FWI_F/FlatFault_B/frequency/frequency9.npy	FWI_F/FlatFault_B/model/model9.npy
FWI_F/FlatFault_B/data/data10.npy	FWI_F/FlatFault_B/frequency/frequency10.npy	FWI_F/FlatFault_B/model/model10.npy
FWI_F/FlatFault_B/data/data11.npy	FWI_F/FlatFault_B/frequency/frequency11.npy	FWI_F/FlatFault_B/model/model11.npy
FWI_F/FlatFault_B/data/data12.npy	FWI_F/FlatFault_B/frequency/frequency12.npy	FWI_F/FlatFault_B/model/model12.npy
FWI_F/FlatFault_B/data/data13.npy	FWI_F/FlatFault_B/frequency/frequency13.npy	FWI_F/FlatFault_B/model/model13.npy
FWI_F/FlatFault_B/data/data14.npy	FWI_F/FlatFault_B/frequency/frequency14.npy	FWI_F/FlatFault_B/model/model14.npy
FWI_F/FlatFault_B/data/data15.npy	FWI_F/FlatFault_B/frequency/frequency15.npy	FWI_F/FlatFault_B/model/model15.npy
FWI_F/FlatFault_B/data/data16.npy	FWI_F/FlatFault_B/frequency/frequency16.npy	FWI_F/FlatFault_B/model/model16.npy
FWI_F/FlatFault_B/data/data17.npy	FWI_F/FlatFault_B/frequency/frequency17.npy	FWI_F/FlatFault_B/model/model17.npy
FWI_F/FlatFault_B/data/data18.npy	FWI_F/FlatFault_B/frequency/frequency18.npy	FWI_F/FlatFault_B/model/model18.npy
FWI_F/FlatFault_B/data/data19.npy	FWI_F/FlatFault_B/frequency/frequency19.npy	FWI_F/FlatFault_B/model/model19.npy
FWI_F/FlatFault_B/data/data20.npy	FWI_F/FlatFault_B/frequency/frequency20.npy	FWI_F/FlatFault_B/model/model20.npy
FWI_F/FlatFault_B/data/data21.npy	FWI_F/FlatFault_B/frequency/frequency21.npy	FWI_F/FlatFault_B/model/model21.npy
FWI_F/FlatFault_B/data/data22.npy	FWI_F/FlatFault_B/frequency/frequency22.npy	FWI_F/FlatFault_B/model/model22.npy
FWI_F/FlatFault_B/data/data23.npy	FWI_F/FlatFault_B/frequency/frequency23.npy	FWI_F/FlatFault_B/model/model23.npy
FWI_F/FlatFault_B/data/data24.npy	FWI_F/FlatFault_B/frequency/frequency24.npy	FWI_F/FlatFault_B/model/model24.npy
FWI_F/FlatFault_B/data/data25.npy	FWI_F/FlatFault_B/frequency/frequency25.npy	FWI_F/FlatFault_B/model/model25.npy
FWI_F/FlatFault_B/data/data26.npy	FWI_F/FlatFault_B/frequency/frequency26.npy	FWI_F/FlatFault_B/model/model26.npy
FWI_F/FlatFault_B/data/data27.npy	FWI_F/FlatFault_B/frequency/frequency27.npy	FWI_F/FlatFault_B/model/model27.npy
FWI_F/FlatFault_B/data/data28.npy	FWI_F/FlatFault_B/frequency/frequency28.npy	FWI_F/FlatFault_B/model/model28.npy
FWI_F/FlatFault_B/data/data29.npy	FWI_F/FlatFault_B/frequency/frequency29.npy	FWI_F/FlatFault_B/model/model29.npy
FWI_F/FlatFault_B/data/data30.npy	FWI_F/FlatFault_B/frequency/frequency30.npy	FWI_F/FlatFault_B/model/model30.npy
FWI_F/FlatFault_B/data/data31.npy	FWI_F/FlatFault_B/frequency/frequency31.npy	FWI_F/FlatFault_B/model/model31.npy
FWI_F/FlatFault_B/data/data32.npy	FWI_F/FlatFault_B/frequency/frequency32.npy	FWI_F/FlatFault_B/model/model32.npy
FWI_F/FlatFault_B/data/data33.npy	FWI_F/FlatFault_B/frequency/frequency33.npy	FWI_F/FlatFault_B/model/model33.npy
FWI_F/FlatFault_B/data/data34.npy	FWI_F/FlatFault_B/frequency/frequency34.npy	FWI_F/FlatFault_B/model/model34.npy
FWI_F/FlatFault_B/data/data35.npy	FWI_F/FlatFault_B/frequency/frequency35.npy	FWI_F/FlatFault_B/model/model35.npy
FWI_F/FlatFault_B/data/data36.npy	FWI_F/FlatFault_B/frequency/frequency36.npy	FWI_F/FlatFault_B/model/model36.npy
FWI_F/FlatFault_B/data/data37.npy	FWI_F/FlatFault_B/frequency/frequency37.npy	FWI_F/FlatFault_B/model/model37.npy
FWI_F/FlatFault_B/data/data38.npy	FWI_F/FlatFault_B/frequency/frequency38.npy	FWI_F/FlatFault_B/model/model38.npy
FWI_F/FlatFault_B/data/data39.npy	FWI_F/FlatFault_B/frequency/frequency39.npy	FWI_F/FlatFault_B/model/model39.npy
FWI_F/FlatFault_B/data/data40.npy	FWI_F/FlatFault_B/frequency/frequency40.npy	FWI_F/FlatFault_B/model/model40.npy
FWI_F/FlatFault_B/data/data41.npy	FWI_F/FlatFault_B/frequency/frequency41.npy	FWI_F/FlatFault_B/model/model41.npy
FWI_F/FlatFault_B/data/data42.npy	FWI_F/FlatFault_B/frequency/frequency42.npy	FWI_F/FlatFault_B/model/model42.npy
FWI_F/FlatFault_B/data/data43.npy	FWI_F/FlatFault_B/frequency/frequency43.npy	FWI_F/FlatFault_B/model/model43.npy
FWI_F/FlatFault_B/data/data44.npy	FWI_F/FlatFault_B/frequency/frequency44.npy	FWI_F/FlatFault_B/model/model44.npy
FWI_F/FlatFault_B/data/data45.npy	FWI_F/FlatFault_B/frequency/frequency45.npy	FWI_F/FlatFault_B/model/model45.npy
FWI_F/FlatFault_B/data/data46.npy	FWI_F/FlatFault_B/frequency/frequency46.npy	FWI_F/FlatFault_B/model/model46.npy
FWI_F/FlatFault_B/data/data47.npy	FWI_F/FlatFault_B/frequency/frequency47.npy	FWI_F/FlatFault_B/model/model47.npy
FWI_F/FlatFault_B/data/data48.npy	FWI_F/FlatFault_B/frequency/frequency48.npy	FWI_F/FlatFault_B/model/model48.npy
FWI_F/FlatFault_B/data/data49.npy	FWI_F/FlatFault_B/frequency/frequency49.npy	FWI_F/FlatFault_B/model/model49.npy
FWI_F/FlatFault_B/data/data50.npy	FWI_F/FlatFault_B/frequency/frequency50.npy	FWI_F/FlatFault_B/model/model50.npy
FWI_F/FlatFault_B/data/data51.npy	FWI_F/FlatFault_B/frequency/frequency51.npy	FWI_F/FlatFault_B/model/model51.npy
FWI_F/FlatFault_B/data/data52.npy	FWI_F/FlatFault_B/frequency/frequency52.npy	FWI_F/FlatFault_B/model/model52.npy
FWI_F/FlatFault_B/data/data53.npy	FWI_F/FlatFault_B/frequency/frequency53.npy	FWI_F/FlatFault_B/model/model53.npy
FWI_F/FlatFault_B/data/data54.npy	FWI_F/FlatFault_B/frequency/frequency54.npy	FWI_F/FlatFault_B/model/model54.npy
FWI_F/FlatFault_B/data/data55.npy	FWI_F/FlatFault_B/frequency/frequency55.npy	FWI_F/FlatFault_B/model/model55.npy
FWI_F/FlatFault_B/data/data56.npy	FWI_F/FlatFault_B/frequency/frequency56.npy	FWI_F/FlatFault_B/model/model56.npy
FWI_F/FlatFault_B/data/data57.npy	FWI_F/FlatFault_B/frequency/frequency57.npy	FWI_F/FlatFault_B/model/model57.npy
FWI_F/FlatFault_B/data/data58.npy	FWI_F/FlatFault_B/frequency/frequency58.npy	FWI_F/FlatFault_B/model/model58.npy
FWI_F/FlatFault_B/data/data59.npy	FWI_F/FlatFault_B/frequency/frequency59.npy	FWI_F/FlatFault_B/model/model59.npy
FWI_F/FlatFault_B/data/data60.npy	FWI_F/FlatFault_B/frequency/frequency60.npy	FWI_F/FlatFault_B/model/model60.npy
FWI_F/FlatFault_B/data/data61.npy	FWI_F/FlatFault_B/frequency/frequency61.npy	FWI_F/FlatFault_B/model/model61.npy
FWI_F/FlatFault_B/data/data62.npy	FWI_F/FlatFault_B/frequency/frequency62.npy	FWI_F/FlatFault_B/model/model62.npy
FWI_F/FlatFault_B/data/data63.npy	FWI_F/FlatFault_B/frequency/frequency63.npy	FWI_F/FlatFault_B/model/model63.npy
FWI_F/FlatFault_B/data/data64.npy	FWI_F/FlatFault_B/frequency/frequency64.npy	FWI_F/FlatFault_B/model/model64.npy
FWI_F/FlatFault_B/data/data65.npy	FWI_F/FlatFault_B/frequency/frequency65.npy	FWI_F/FlatFault_B/model/model65.npy
FWI_F/FlatFault_B/data/data66.npy	FWI_F/FlatFault_B/frequency/frequency66.npy	FWI_F/FlatFault_B/model/model66.npy
FWI_F/FlatFault_B/data/data67.npy	FWI_F/FlatFault_B/frequency/frequency67.npy	FWI_F/FlatFault_B/model/model67.npy
FWI_F/FlatFault_B/data/data68.npy	FWI_F/FlatFault_B/frequency/frequency68.npy	FWI_F/FlatFault_B/model/model68.npy
FWI_F/FlatFault_B/data/data69.npy	FWI_F/FlatFault_B/frequency/frequency69.npy	FWI_F/FlatFault_B/model/model69.npy
FWI_F/FlatFault_B/data/data70.npy	FWI_F/FlatFault_B/frequency/frequency70.npy	FWI_F/FlatFault_B/model/model70.npy
FWI_F/FlatFault_B/data/data71.npy	FWI_F/FlatFault_B/frequency/frequency71.npy	FWI_F/FlatFault_B/model/model71.npy
FWI_F/FlatFault_B/data/data72.npy	FWI_F/FlatFault_B/frequency/frequency72.npy	FWI_F/FlatFault_B/model/model72.npy
FWI_F/FlatFault_B/data/data73.npy	FWI_F/FlatFault_B/frequency/frequency73.npy	FWI_F/FlatFault_B/model/model73.npy
FWI_F/FlatFault_B/data/data74.npy	FWI_F/FlatFault_B/frequency/frequency74.npy	FWI_F/FlatFault_B/model/model74.npy
FWI_F/FlatFault_B/data/data75.npy	FWI_F/FlatFault_B/frequency/frequency75.npy	FWI_F/FlatFault_B/model/model75.npy
FWI_F/FlatFault_B/data/data76.npy	FWI_F/FlatFault_B/frequency/frequency76.npy	FWI_F/FlatFault_B/model/model76.npy
FWI_F/FlatFault_B/data/data77.npy	FWI_F/FlatFault_B/frequency/frequency77.npy	FWI_F/FlatFault_B/model/model77.npy
FWI_F/FlatFault_B/data/data78.npy	FWI_F/FlatFault_B/frequency/frequency78.npy	FWI_F/FlatFault_B/model/model78.npy
FWI_F/FlatFault_B/data/data79.npy	FWI_F/FlatFault_B/frequency/frequency79.npy	FWI_F/FlatFault_B/model/model79.npy
FWI_F/FlatFault_B/data/data80.npy	FWI_F/FlatFault_B/frequency/frequency80.npy	FWI_F/FlatFault_B/model/model80.npy
FWI_F/FlatFault_B/data/data81.npy	FWI_F/FlatFault_B/frequency/frequency81.npy	FWI_F/FlatFault_B/model/model81.npy
FWI_F/FlatFault_B/data/data82.npy	FWI_F/FlatFault_B/frequency/frequency82.npy	FWI_F/FlatFault_B/model/model82.npy
FWI_F/FlatFault_B/data/data83.npy	FWI_F/FlatFault_B/frequency/frequency83.npy	FWI_F/FlatFault_B/model/model83.npy
FWI_F/FlatFault_B/data/data84.npy	FWI_F/FlatFault_B/frequency/frequency84.npy	FWI_F/FlatFault_B/model/model84.npy
FWI_F/FlatFault_B/data/data85.npy	FWI_F/FlatFault_B/frequency/frequency85.npy	FWI_F/FlatFault_B/model/model85.npy
FWI_F/FlatFault_B/data/data86.npy	FWI_F/FlatFault_B/frequency/frequency86.npy	FWI_F/FlatFault_B/model/model86.npy
FWI_F/FlatFault_B/data/data87.npy	FWI_F/FlatFault_B/frequency/frequency87.npy	FWI_F/FlatFault_B/model/model87.npy
FWI_F/FlatFault_B/data/data88.npy	FWI_F/FlatFault_B/frequency/frequency88.npy	FWI_F/FlatFault_B/model/model88.npy
FWI_F/FlatFault_B/data/data89.npy	FWI_F/FlatFault_B/frequency/frequency89.npy	FWI_F/FlatFault_B/model/model89.npy
FWI_F/FlatFault_B/data/data90.npy	FWI_F/FlatFault_B/frequency/frequency90.npy	FWI_F/FlatFault_B/model/model90.npy
FWI_F/FlatFault_B/data/data91.npy	FWI_F/FlatFault_B/frequency/frequency91.npy	FWI_F/FlatFault_B/model/model91.npy
FWI_F/FlatFault_B/data/data92.npy	FWI_F/FlatFault_B/frequency/frequency92.npy	FWI_F/FlatFault_B/model/model92.npy
FWI_F/FlatFault_B/data/data93.npy	FWI_F/FlatFault_B/frequency/frequency93.npy	FWI_F/FlatFault_B/model/model93.npy
FWI_F/FlatFault_B/data/data94.npy	FWI_F/FlatFault_B/frequency/frequency94.npy	FWI_F/FlatFault_B/model/model94.npy
FWI_F/FlatFault_B/data/data95.npy	FWI_F/FlatFault_B/frequency/frequency95.npy	FWI_F/FlatFault_B/model/model95.npy
FWI_F/FlatFault_B/data/data96.npy	FWI_F/FlatFault_B/frequency/frequency96.npy	FWI_F/FlatFault_B/model/model96.npy
FWI_F/FlatFault_B/data/data97.npy	FWI_F/FlatFault_B/frequency/frequency97.npy	FWI_F/FlatFault_B/model/model97.npy
FWI_F/FlatFault_B/data/data98.npy	FWI_F/FlatFault_B/frequency/frequency98.npy	FWI_F/FlatFault_B/model/model98.npy
FWI_F/FlatFault_B/data/data99.npy	FWI_F/FlatFault_B/frequency/frequency99.npy	FWI_F/FlatFault_B/model/model99.npy
FWI_F/FlatFault_B/data/data100.npy	FWI_F/FlatFault_B/frequency/frequency100.npy	FWI_F/FlatFault_B/model/model100.npy
FWI_F/FlatFault_B/data/data101.npy	FWI_F/FlatFault_B/frequency/frequency101.npy	FWI_F/FlatFault_B/model/model101.npy
FWI_F/FlatFault_B/data/data102.npy	FWI_F/FlatFault_B/frequency/frequency102.npy	FWI_F/FlatFault_B/model/model102.npy
FWI_F/FlatFault_B/data/data103.npy	FWI_F/FlatFault_B/frequency/frequency103.npy	FWI_F/FlatFault_B/model/model103.npy
FWI_F/FlatFault_B/data/data104.npy	FWI_F/FlatFault_B/frequency/frequency104.npy	FWI_F/FlatFault_B/model/model104.npy
FWI_F/FlatFault_B/data/data105.npy	FWI_F/FlatFault_B/frequency/frequency105.npy	FWI_F/FlatFault_B/model/model105.npy
FWI_F/FlatFault_B/data/data106.npy	FWI_F/FlatFault_B/frequency/frequency106.npy	FWI_F/FlatFault_B/model/model106.npy
FWI_F/FlatFault_B/data/data107.npy	FWI_F/FlatFault_B/frequency/frequency107.npy	FWI_F/FlatFault_B/model/model107.npy
FWI_F/FlatFault_B/data/data108.npy	FWI_F/FlatFault_B/frequency/frequency108.npy	FWI_F/FlatFault_B/model/model108.npy
