FWI_L/FlatFault_B/data/data1.npy	FWI_L/FlatFault_B/source/source1.npy	FWI_L/FlatFault_B/model/model1.npy
FWI_L/FlatFault_B/data/data2.npy	FWI_L/FlatFault_B/source/source2.npy	FWI_L/FlatFault_B/model/model2.npy
FWI_L/FlatFault_B/data/data3.npy	FWI_L/FlatFault_B/source/source3.npy	FWI_L/FlatFault_B/model/model3.npy
FWI_L/FlatFault_B/data/data4.npy	FWI_L/FlatFault_B/source/source4.npy	FWI_L/FlatFault_B/model/model4.npy
FWI_L/FlatFault_B/data/data5.npy	FWI_L/FlatFault_B/source/source5.npy	FWI_L/FlatFault_B/model/model5.npy
FWI_L/FlatFault_B/data/data6.npy	FWI_L/FlatFault_B/source/source6.npy	FWI_L/FlatFault_B/model/model6.npy
FWI_L/FlatFault_B/data/data7.npy	FWI_L/FlatFault_B/source/source7.npy	FWI_L/FlatFault_B/model/model7.npy
FWI_L/FlatFault_B/data/data8.npy	FWI_L/FlatFault_B/source/source8.npy	FWI_L/FlatFault_B/model/model8.npy
FWI_L/FlatFault_B/data/data9.npy	FWI_L/FlatFault_B/source/source9.npy	FWI_L/FlatFault_B/model/model9.npy
FWI_L/FlatFault_B/data/data10.npy	FWI_L/FlatFault_B/source/source10.npy	FWI_L/FlatFault_B/model/model10.npy
FWI_L/FlatFault_B/data/data11.npy	FWI_L/FlatFault_B/source/source11.npy	FWI_L/FlatFault_B/model/model11.npy
FWI_L/FlatFault_B/data/data12.npy	FWI_L/FlatFault_B/source/source12.npy	FWI_L/FlatFault_B/model/model12.npy
FWI_L/FlatFault_B/data/data13.npy	FWI_L/FlatFault_B/source/source13.npy	FWI_L/FlatFault_B/model/model13.npy
FWI_L/FlatFault_B/data/data14.npy	FWI_L/FlatFault_B/source/source14.npy	FWI_L/FlatFault_B/model/model14.npy
FWI_L/FlatFault_B/data/data15.npy	FWI_L/FlatFault_B/source/source15.npy	FWI_L/FlatFault_B/model/model15.npy
FWI_L/FlatFault_B/data/data16.npy	FWI_L/FlatFault_B/source/source16.npy	FWI_L/FlatFault_B/model/model16.npy
FWI_L/FlatFault_B/data/data17.npy	FWI_L/FlatFault_B/source/source17.npy	FWI_L/FlatFault_B/model/model17.npy
FWI_L/FlatFault_B/data/data18.npy	FWI_L/FlatFault_B/source/source18.npy	FWI_L/FlatFault_B/model/model18.npy
FWI_L/FlatFault_B/data/data19.npy	FWI_L/FlatFault_B/source/source19.npy	FWI_L/FlatFault_B/model/model19.npy
FWI_L/FlatFault_B/data/data20.npy	FWI_L/FlatFault_B/source/source20.npy	FWI_L/FlatFault_B/model/model20.npy
FWI_L/FlatFault_B/data/data21.npy	FWI_L/FlatFault_B/source/source21.npy	FWI_L/FlatFault_B/model/model21.npy
FWI_L/FlatFault_B/data/data22.npy	FWI_L/FlatFault_B/source/source22.npy	FWI_L/FlatFault_B/model/model22.npy
FWI_L/FlatFault_B/data/data23.npy	FWI_L/FlatFault_B/source/source23.npy	FWI_L/FlatFault_B/model/model23.npy
FWI_L/FlatFault_B/data/data24.npy	FWI_L/FlatFault_B/source/source24.npy	FWI_L/FlatFault_B/model/model24.npy
FWI_L/FlatFault_B/data/data25.npy	FWI_L/FlatFault_B/source/source25.npy	FWI_L/FlatFault_B/model/model25.npy
FWI_L/FlatFault_B/data/data26.npy	FWI_L/FlatFault_B/source/source26.npy	FWI_L/FlatFault_B/model/model26.npy
FWI_L/FlatFault_B/data/data27.npy	FWI_L/FlatFault_B/source/source27.npy	FWI_L/FlatFault_B/model/model27.npy
FWI_L/FlatFault_B/data/data28.npy	FWI_L/FlatFault_B/source/source28.npy	FWI_L/FlatFault_B/model/model28.npy
FWI_L/FlatFault_B/data/data29.npy	FWI_L/FlatFault_B/source/source29.npy	FWI_L/FlatFault_B/model/model29.npy
FWI_L/FlatFault_B/data/data30.npy	FWI_L/FlatFault_B/source/source30.npy	FWI_L/FlatFault_B/model/model30.npy
FWI_L/FlatFault_B/data/data31.npy	FWI_L/FlatFault_B/source/source31.npy	FWI_L/FlatFault_B/model/model31.npy
FWI_L/FlatFault_B/data/data32.npy	FWI_L/FlatFault_B/source/source32.npy	FWI_L/FlatFault_B/model/model32.npy
FWI_L/FlatFault_B/data/data33.npy	FWI_L/FlatFault_B/source/source33.npy	FWI_L/FlatFault_B/model/model33.npy
FWI_L/FlatFault_B/data/data34.npy	FWI_L/FlatFault_B/source/source34.npy	FWI_L/FlatFault_B/model/model34.npy
FWI_L/FlatFault_B/data/data35.npy	FWI_L/FlatFault_B/source/source35.npy	FWI_L/FlatFault_B/model/model35.npy
FWI_L/FlatFault_B/data/data36.npy	FWI_L/FlatFault_B/source/source36.npy	FWI_L/FlatFault_B/model/model36.npy
FWI_L/FlatFault_B/data/data37.npy	FWI_L/FlatFault_B/source/source37.npy	FWI_L/FlatFault_B/model/model37.npy
FWI_L/FlatFault_B/data/data38.npy	FWI_L/FlatFault_B/source/source38.npy	FWI_L/FlatFault_B/model/model38.npy
FWI_L/FlatFault_B/data/data39.npy	FWI_L/FlatFault_B/source/source39.npy	FWI_L/FlatFault_B/model/model39.npy
FWI_L/FlatFault_B/data/data40.npy	FWI_L/FlatFault_B/source/source40.npy	FWI_L/FlatFault_B/model/model40.npy
FWI_L/FlatFault_B/data/data41.npy	FWI_L/FlatFault_B/source/source41.npy	FWI_L/FlatFault_B/model/model41.npy
FWI_L/FlatFault_B/data/data42.npy	FWI_L/FlatFault_B/source/source42.npy	FWI_L/FlatFault_B/model/model42.npy
FWI_L/FlatFault_B/data/data43.npy	FWI_L/FlatFault_B/source/source43.npy	FWI_L/FlatFault_B/model/model43.npy
FWI_L/FlatFault_B/data/data44.npy	FWI_L/FlatFault_B/source/source44.npy	FWI_L/FlatFault_B/model/model44.npy
FWI_L/FlatFault_B/data/data45.npy	FWI_L/FlatFault_B/source/source45.npy	FWI_L/FlatFault_B/model/model45.npy
FWI_L/FlatFault_B/data/data46.npy	FWI_L/FlatFault_B/source/source46.npy	FWI_L/FlatFault_B/model/model46.npy
FWI_L/FlatFault_B/data/data47.npy	FWI_L/FlatFault_B/source/source47.npy	FWI_L/FlatFault_B/model/model47.npy
FWI_L/FlatFault_B/data/data48.npy	FWI_L/FlatFault_B/source/source48.npy	FWI_L/FlatFault_B/model/model48.npy
FWI_L/FlatFault_B/data/data49.npy	FWI_L/FlatFault_B/source/source49.npy	FWI_L/FlatFault_B/model/model49.npy
FWI_L/FlatFault_B/data/data50.npy	FWI_L/FlatFault_B/source/source50.npy	FWI_L/FlatFault_B/model/model50.npy
FWI_L/FlatFault_B/data/data51.npy	FWI_L/FlatFault_B/source/source51.npy	FWI_L/FlatFault_B/model/model51.npy
FWI_L/FlatFault_B/data/data52.npy	FWI_L/FlatFault_B/source/source52.npy	FWI_L/FlatFault_B/model/model52.npy
FWI_L/FlatFault_B/data/data53.npy	FWI_L/FlatFault_B/source/source53.npy	FWI_L/FlatFault_B/model/model53.npy
FWI_L/FlatFault_B/data/data54.npy	FWI_L/FlatFault_B/source/source54.npy	FWI_L/FlatFault_B/model/model54.npy
FWI_L/FlatFault_B/data/data55.npy	FWI_L/FlatFault_B/source/source55.npy	FWI_L/FlatFault_B/model/model55.npy
FWI_L/FlatFault_B/data/data56.npy	FWI_L/FlatFault_B/source/source56.npy	FWI_L/FlatFault_B/model/model56.npy
FWI_L/FlatFault_B/data/data57.npy	FWI_L/FlatFault_B/source/source57.npy	FWI_L/FlatFault_B/model/model57.npy
FWI_L/FlatFault_B/data/data58.npy	FWI_L/FlatFault_B/source/source58.npy	FWI_L/FlatFault_B/model/model58.npy
FWI_L/FlatFault_B/data/data59.npy	FWI_L/FlatFault_B/source/source59.npy	FWI_L/FlatFault_B/model/model59.npy
FWI_L/FlatFault_B/data/data60.npy	FWI_L/FlatFault_B/source/source60.npy	FWI_L/FlatFault_B/model/model60.npy
FWI_L/FlatFault_B/data/data61.npy	FWI_L/FlatFault_B/source/source61.npy	FWI_L/FlatFault_B/model/model61.npy
FWI_L/FlatFault_B/data/data62.npy	FWI_L/FlatFault_B/source/source62.npy	FWI_L/FlatFault_B/model/model62.npy
FWI_L/FlatFault_B/data/data63.npy	FWI_L/FlatFault_B/source/source63.npy	FWI_L/FlatFault_B/model/model63.npy
FWI_L/FlatFault_B/data/data64.npy	FWI_L/FlatFault_B/source/source64.npy	FWI_L/FlatFault_B/model/model64.npy
FWI_L/FlatFault_B/data/data65.npy	FWI_L/FlatFault_B/source/source65.npy	FWI_L/FlatFault_B/model/model65.npy
FWI_L/FlatFault_B/data/data66.npy	FWI_L/FlatFault_B/source/source66.npy	FWI_L/FlatFault_B/model/model66.npy
FWI_L/FlatFault_B/data/data67.npy	FWI_L/FlatFault_B/source/source67.npy	FWI_L/FlatFault_B/model/model67.npy
FWI_L/FlatFault_B/data/data68.npy	FWI_L/FlatFault_B/source/source68.npy	FWI_L/FlatFault_B/model/model68.npy
FWI_L/FlatFault_B/data/data69.npy	FWI_L/FlatFault_B/source/source69.npy	FWI_L/FlatFault_B/model/model69.npy
FWI_L/FlatFault_B/data/data70.npy	FWI_L/FlatFault_B/source/source70.npy	FWI_L/FlatFault_B/model/model70.npy
FWI_L/FlatFault_B/data/data71.npy	FWI_L/FlatFault_B/source/source71.npy	FWI_L/FlatFault_B/model/model71.npy
FWI_L/FlatFault_B/data/data72.npy	FWI_L/FlatFault_B/source/source72.npy	FWI_L/FlatFault_B/model/model72.npy
FWI_L/FlatFault_B/data/data73.npy	FWI_L/FlatFault_B/source/source73.npy	FWI_L/FlatFault_B/model/model73.npy
FWI_L/FlatFault_B/data/data74.npy	FWI_L/FlatFault_B/source/source74.npy	FWI_L/FlatFault_B/model/model74.npy
FWI_L/FlatFault_B/data/data75.npy	FWI_L/FlatFault_B/source/source75.npy	FWI_L/FlatFault_B/model/model75.npy
FWI_L/FlatFault_B/data/data76.npy	FWI_L/FlatFault_B/source/source76.npy	FWI_L/FlatFault_B/model/model76.npy
FWI_L/FlatFault_B/data/data77.npy	FWI_L/FlatFault_B/source/source77.npy	FWI_L/FlatFault_B/model/model77.npy
FWI_L/FlatFault_B/data/data78.npy	FWI_L/FlatFault_B/source/source78.npy	FWI_L/FlatFault_B/model/model78.npy
FWI_L/FlatFault_B/data/data79.npy	FWI_L/FlatFault_B/source/source79.npy	FWI_L/FlatFault_B/model/model79.npy
FWI_L/FlatFault_B/data/data80.npy	FWI_L/FlatFault_B/source/source80.npy	FWI_L/FlatFault_B/model/model80.npy
FWI_L/FlatFault_B/data/data81.npy	FWI_L/FlatFault_B/source/source81.npy	FWI_L/FlatFault_B/model/model81.npy
FWI_L/FlatFault_B/data/data82.npy	FWI_L/FlatFault_B/source/source82.npy	FWI_L/FlatFault_B/model/model82.npy
FWI_L/FlatFault_B/data/data83.npy	FWI_L/FlatFault_B/source/source83.npy	FWI_L/FlatFault_B/model/model83.npy
FWI_L/FlatFault_B/data/data84.npy	FWI_L/FlatFault_B/source/source84.npy	FWI_L/FlatFault_B/model/model84.npy
FWI_L/FlatFault_B/data/data85.npy	FWI_L/FlatFault_B/source/source85.npy	FWI_L/FlatFault_B/model/model85.npy
FWI_L/FlatFault_B/data/data86.npy	FWI_L/FlatFault_B/source/source86.npy	FWI_L/FlatFault_B/model/model86.npy
FWI_L/FlatFault_B/data/data87.npy	FWI_L/FlatFault_B/source/source87.npy	FWI_L/FlatFault_B/model/model87.npy
FWI_L/FlatFault_B/data/data88.npy	FWI_L/FlatFault_B/source/source88.npy	FWI_L/FlatFault_B/model/model88.npy
FWI_L/FlatFault_B/data/data89.npy	FWI_L/FlatFault_B/source/source89.npy	FWI_L/FlatFault_B/model/model89.npy
FWI_L/FlatFault_B/data/data90.npy	FWI_L/FlatFault_B/source/source90.npy	FWI_L/FlatFault_B/model/model90.npy
FWI_L/FlatFault_B/data/data91.npy	FWI_L/FlatFault_B/source/source91.npy	FWI_L/FlatFault_B/model/model91.npy
FWI_L/FlatFault_B/data/data92.npy	FWI_L/FlatFault_B/source/source92.npy	FWI_L/FlatFault_B/model/model92.npy
FWI_L/FlatFault_B/data/data93.npy	FWI_L/FlatFault_B/source/source93.npy	FWI_L/FlatFault_B/model/model93.npy
FWI_L/FlatFault_B/data/data94.npy	FWI_L/FlatFault_B/source/source94.npy	FWI_L/FlatFault_B/model/model94.npy
FWI_L/FlatFault_B/data/data95.npy	FWI_L/FlatFault_B/source/source95.npy	FWI_L/FlatFault_B/model/model95.npy
FWI_L/FlatFault_B/data/data96.npy	FWI_L/FlatFault_B/source/source96.npy	FWI_L/FlatFault_B/model/model96.npy
FWI_L/FlatFault_B/data/data97.npy	FWI_L/FlatFault_B/source/source97.npy	FWI_L/FlatFault_B/model/model97.npy
FWI_L/FlatFault_B/data/data98.npy	FWI_L/FlatFault_B/source/source98.npy	FWI_L/FlatFault_B/model/model98.npy
FWI_L/FlatFault_B/data/data99.npy	FWI_L/FlatFault_B/source/source99.npy	FWI_L/FlatFault_B/model/model99.npy
FWI_L/FlatFault_B/data/data100.npy	FWI_L/FlatFault_B/source/source100.npy	FWI_L/FlatFault_B/model/model100.npy
FWI_L/FlatFault_B/data/data101.npy	FWI_L/FlatFault_B/source/source101.npy	FWI_L/FlatFault_B/model/model101.npy
FWI_L/FlatFault_B/data/data102.npy	FWI_L/FlatFault_B/source/source102.npy	FWI_L/FlatFault_B/model/model102.npy
FWI_L/FlatFault_B/data/data103.npy	FWI_L/FlatFault_B/source/source103.npy	FWI_L/FlatFault_B/model/model103.npy
FWI_L/FlatFault_B/data/data104.npy	FWI_L/FlatFault_B/source/source104.npy	FWI_L/FlatFault_B/model/model104.npy
FWI_L/FlatFault_B/data/data105.npy	FWI_L/FlatFault_B/source/source105.npy	FWI_L/FlatFault_B/model/model105.npy
FWI_L/FlatFault_B/data/data106.npy	FWI_L/FlatFault_B/source/source106.npy	FWI_L/FlatFault_B/model/model106.npy
FWI_L/FlatFault_B/data/data107.npy	FWI_L/FlatFault_B/source/source107.npy	FWI_L/FlatFault_B/model/model107.npy
FWI_L/FlatFault_B/data/data108.npy	FWI_L/FlatFault_B/source/source108.npy	FWI_L/FlatFault_B/model/model108.npy
