FWI_L/FlatVel_B/data/data1.npy	FWI_L/FlatVel_B/source/source1.npy	FWI_L/FlatVel_B/model/model1.npy
FWI_L/FlatVel_B/data/data2.npy	FWI_L/FlatVel_B/source/source2.npy	FWI_L/FlatVel_B/model/model2.npy
FWI_L/FlatVel_B/data/data3.npy	FWI_L/FlatVel_B/source/source3.npy	FWI_L/FlatVel_B/model/model3.npy
FWI_L/FlatVel_B/data/data4.npy	FWI_L/FlatVel_B/source/source4.npy	FWI_L/FlatVel_B/model/model4.npy
FWI_L/FlatVel_B/data/data5.npy	FWI_L/FlatVel_B/source/source5.npy	FWI_L/FlatVel_B/model/model5.npy
FWI_L/FlatVel_B/data/data6.npy	FWI_L/FlatVel_B/source/source6.npy	FWI_L/FlatVel_B/model/model6.npy
FWI_L/FlatVel_B/data/data7.npy	FWI_L/FlatVel_B/source/source7.npy	FWI_L/FlatVel_B/model/model7.npy
FWI_L/FlatVel_B/data/data8.npy	FWI_L/FlatVel_B/source/source8.npy	FWI_L/FlatVel_B/model/model8.npy
FWI_L/FlatVel_B/data/data9.npy	FWI_L/FlatVel_B/source/source9.npy	FWI_L/FlatVel_B/model/model9.npy
FWI_L/FlatVel_B/data/data10.npy	FWI_L/FlatVel_B/source/source10.npy	FWI_L/FlatVel_B/model/model10.npy
FWI_L/FlatVel_B/data/data11.npy	FWI_L/FlatVel_B/source/source11.npy	FWI_L/FlatVel_B/model/model11.npy
FWI_L/FlatVel_B/data/data12.npy	FWI_L/FlatVel_B/source/source12.npy	FWI_L/FlatVel_B/model/model12.npy
FWI_L/FlatVel_B/data/data13.npy	FWI_L/FlatVel_B/source/source13.npy	FWI_L/FlatVel_B/model/model13.npy
FWI_L/FlatVel_B/data/data14.npy	FWI_L/FlatVel_B/source/source14.npy	FWI_L/FlatVel_B/model/model14.npy
FWI_L/FlatVel_B/data/data15.npy	FWI_L/FlatVel_B/source/source15.npy	FWI_L/FlatVel_B/model/model15.npy
FWI_L/FlatVel_B/data/data16.npy	FWI_L/FlatVel_B/source/source16.npy	FWI_L/FlatVel_B/model/model16.npy
FWI_L/FlatVel_B/data/data17.npy	FWI_L/FlatVel_B/source/source17.npy	FWI_L/FlatVel_B/model/model17.npy
FWI_L/FlatVel_B/data/data18.npy	FWI_L/FlatVel_B/source/source18.npy	FWI_L/FlatVel_B/model/model18.npy
FWI_L/FlatVel_B/data/data19.npy	FWI_L/FlatVel_B/source/source19.npy	FWI_L/FlatVel_B/model/model19.npy
FWI_L/FlatVel_B/data/data20.npy	FWI_L/FlatVel_B/source/source20.npy	FWI_L/FlatVel_B/model/model20.npy
FWI_L/FlatVel_B/data/data21.npy	FWI_L/FlatVel_B/source/source21.npy	FWI_L/FlatVel_B/model/model21.npy
FWI_L/FlatVel_B/data/data22.npy	FWI_L/FlatVel_B/source/source22.npy	FWI_L/FlatVel_B/model/model22.npy
FWI_L/FlatVel_B/data/data23.npy	FWI_L/FlatVel_B/source/source23.npy	FWI_L/FlatVel_B/model/model23.npy
FWI_L/FlatVel_B/data/data24.npy	FWI_L/FlatVel_B/source/source24.npy	FWI_L/FlatVel_B/model/model24.npy
FWI_L/FlatVel_B/data/data25.npy	FWI_L/FlatVel_B/source/source25.npy	FWI_L/FlatVel_B/model/model25.npy
FWI_L/FlatVel_B/data/data26.npy	FWI_L/FlatVel_B/source/source26.npy	FWI_L/FlatVel_B/model/model26.npy
FWI_L/FlatVel_B/data/data27.npy	FWI_L/FlatVel_B/source/source27.npy	FWI_L/FlatVel_B/model/model27.npy
FWI_L/FlatVel_B/data/data28.npy	FWI_L/FlatVel_B/source/source28.npy	FWI_L/FlatVel_B/model/model28.npy
FWI_L/FlatVel_B/data/data29.npy	FWI_L/FlatVel_B/source/source29.npy	FWI_L/FlatVel_B/model/model29.npy
FWI_L/FlatVel_B/data/data30.npy	FWI_L/FlatVel_B/source/source30.npy	FWI_L/FlatVel_B/model/model30.npy
FWI_L/FlatVel_B/data/data31.npy	FWI_L/FlatVel_B/source/source31.npy	FWI_L/FlatVel_B/model/model31.npy
FWI_L/FlatVel_B/data/data32.npy	FWI_L/FlatVel_B/source/source32.npy	FWI_L/FlatVel_B/model/model32.npy
FWI_L/FlatVel_B/data/data33.npy	FWI_L/FlatVel_B/source/source33.npy	FWI_L/FlatVel_B/model/model33.npy
FWI_L/FlatVel_B/data/data34.npy	FWI_L/FlatVel_B/source/source34.npy	FWI_L/FlatVel_B/model/model34.npy
FWI_L/FlatVel_B/data/data35.npy	FWI_L/FlatVel_B/source/source35.npy	FWI_L/FlatVel_B/model/model35.npy
FWI_L/FlatVel_B/data/data36.npy	FWI_L/FlatVel_B/source/source36.npy	FWI_L/FlatVel_B/model/model36.npy
FWI_L/FlatVel_B/data/data37.npy	FWI_L/FlatVel_B/source/source37.npy	FWI_L/FlatVel_B/model/model37.npy
FWI_L/FlatVel_B/data/data38.npy	FWI_L/FlatVel_B/source/source38.npy	FWI_L/FlatVel_B/model/model38.npy
FWI_L/FlatVel_B/data/data39.npy	FWI_L/FlatVel_B/source/source39.npy	FWI_L/FlatVel_B/model/model39.npy
FWI_L/FlatVel_B/data/data40.npy	FWI_L/FlatVel_B/source/source40.npy	FWI_L/FlatVel_B/model/model40.npy
FWI_L/FlatVel_B/data/data41.npy	FWI_L/FlatVel_B/source/source41.npy	FWI_L/FlatVel_B/model/model41.npy
FWI_L/FlatVel_B/data/data42.npy	FWI_L/FlatVel_B/source/source42.npy	FWI_L/FlatVel_B/model/model42.npy
FWI_L/FlatVel_B/data/data43.npy	FWI_L/FlatVel_B/source/source43.npy	FWI_L/FlatVel_B/model/model43.npy
FWI_L/FlatVel_B/data/data44.npy	FWI_L/FlatVel_B/source/source44.npy	FWI_L/FlatVel_B/model/model44.npy
FWI_L/FlatVel_B/data/data45.npy	FWI_L/FlatVel_B/source/source45.npy	FWI_L/FlatVel_B/model/model45.npy
FWI_L/FlatVel_B/data/data46.npy	FWI_L/FlatVel_B/source/source46.npy	FWI_L/FlatVel_B/model/model46.npy
FWI_L/FlatVel_B/data/data47.npy	FWI_L/FlatVel_B/source/source47.npy	FWI_L/FlatVel_B/model/model47.npy
FWI_L/FlatVel_B/data/data48.npy	FWI_L/FlatVel_B/source/source48.npy	FWI_L/FlatVel_B/model/model48.npy
