FWI_L/FlatVel_B/data/data1.npy	FWI_L/FlatVel_B/model/model1.npy
FWI_L/FlatVel_B/data/data2.npy	FWI_L/FlatVel_B/model/model2.npy
FWI_L/FlatVel_B/data/data3.npy	FWI_L/FlatVel_B/model/model3.npy
FWI_L/FlatVel_B/data/data4.npy	FWI_L/FlatVel_B/model/model4.npy
FWI_L/FlatVel_B/data/data5.npy	FWI_L/FlatVel_B/model/model5.npy
FWI_L/FlatVel_B/data/data6.npy	FWI_L/FlatVel_B/model/model6.npy
FWI_L/FlatVel_B/data/data7.npy	FWI_L/FlatVel_B/model/model7.npy
FWI_L/FlatVel_B/data/data8.npy	FWI_L/FlatVel_B/model/model8.npy
FWI_L/FlatVel_B/data/data9.npy	FWI_L/FlatVel_B/model/model9.npy
FWI_L/FlatVel_B/data/data10.npy	FWI_L/FlatVel_B/model/model10.npy
FWI_L/FlatVel_B/data/data11.npy	FWI_L/FlatVel_B/model/model11.npy
FWI_L/FlatVel_B/data/data12.npy	FWI_L/FlatVel_B/model/model12.npy
FWI_L/FlatVel_B/data/data13.npy	FWI_L/FlatVel_B/model/model13.npy
FWI_L/FlatVel_B/data/data14.npy	FWI_L/FlatVel_B/model/model14.npy
FWI_L/FlatVel_B/data/data15.npy	FWI_L/FlatVel_B/model/model15.npy
FWI_L/FlatVel_B/data/data16.npy	FWI_L/FlatVel_B/model/model16.npy
FWI_L/FlatVel_B/data/data17.npy	FWI_L/FlatVel_B/model/model17.npy
FWI_L/FlatVel_B/data/data18.npy	FWI_L/FlatVel_B/model/model18.npy
FWI_L/FlatVel_B/data/data19.npy	FWI_L/FlatVel_B/model/model19.npy
FWI_L/FlatVel_B/data/data20.npy	FWI_L/FlatVel_B/model/model20.npy
FWI_L/FlatVel_B/data/data21.npy	FWI_L/FlatVel_B/model/model21.npy
FWI_L/FlatVel_B/data/data22.npy	FWI_L/FlatVel_B/model/model22.npy
FWI_L/FlatVel_B/data/data23.npy	FWI_L/FlatVel_B/model/model23.npy
FWI_L/FlatVel_B/data/data24.npy	FWI_L/FlatVel_B/model/model24.npy
FWI_L/FlatVel_B/data/data25.npy	FWI_L/FlatVel_B/model/model25.npy
FWI_L/FlatVel_B/data/data26.npy	FWI_L/FlatVel_B/model/model26.npy
FWI_L/FlatVel_B/data/data27.npy	FWI_L/FlatVel_B/model/model27.npy
FWI_L/FlatVel_B/data/data28.npy	FWI_L/FlatVel_B/model/model28.npy
FWI_L/FlatVel_B/data/data29.npy	FWI_L/FlatVel_B/model/model29.npy
FWI_L/FlatVel_B/data/data30.npy	FWI_L/FlatVel_B/model/model30.npy
FWI_L/FlatVel_B/data/data31.npy	FWI_L/FlatVel_B/model/model31.npy
FWI_L/FlatVel_B/data/data32.npy	FWI_L/FlatVel_B/model/model32.npy
FWI_L/FlatVel_B/data/data33.npy	FWI_L/FlatVel_B/model/model33.npy
FWI_L/FlatVel_B/data/data34.npy	FWI_L/FlatVel_B/model/model34.npy
FWI_L/FlatVel_B/data/data35.npy	FWI_L/FlatVel_B/model/model35.npy
FWI_L/FlatVel_B/data/data36.npy	FWI_L/FlatVel_B/model/model36.npy
FWI_L/FlatVel_B/data/data37.npy	FWI_L/FlatVel_B/model/model37.npy
FWI_L/FlatVel_B/data/data38.npy	FWI_L/FlatVel_B/model/model38.npy
FWI_L/FlatVel_B/data/data39.npy	FWI_L/FlatVel_B/model/model39.npy
FWI_L/FlatVel_B/data/data40.npy	FWI_L/FlatVel_B/model/model40.npy
FWI_L/FlatVel_B/data/data41.npy	FWI_L/FlatVel_B/model/model41.npy
FWI_L/FlatVel_B/data/data42.npy	FWI_L/FlatVel_B/model/model42.npy
FWI_L/FlatVel_B/data/data43.npy	FWI_L/FlatVel_B/model/model43.npy
FWI_L/FlatVel_B/data/data44.npy	FWI_L/FlatVel_B/model/model44.npy
FWI_L/FlatVel_B/data/data45.npy	FWI_L/FlatVel_B/model/model45.npy
FWI_L/FlatVel_B/data/data46.npy	FWI_L/FlatVel_B/model/model46.npy
FWI_L/FlatVel_B/data/data47.npy	FWI_L/FlatVel_B/model/model47.npy
FWI_L/FlatVel_B/data/data48.npy	FWI_L/FlatVel_B/model/model48.npy
